Multichar_Symbols
+ADV
+AUX
+DEM
+IMP
+MDF
+MOD
+N
+NUM
+OBL
+P
+PL
+PNN
+PRO
+PT
+PVB
+QUA
+SUB
+VI
+VOC
+VT
-1PL
-1PL.II
-1SG.II
-2PL
-2PL.II
-2SG.II
-3.II
-3PL
-3PL.II
-3PL.INDP
-ATTR
-SX
-T
-TR
-VAL
.I
1=
1PL
1PL.III
1SG.III
2=
2PL
2PL.III
2SG
2SG.III
3.III
3=
3PL.III
=1.I
=2.I
=CN
=EPIS
=PN
=PR.EV
=PROX
=QUDD
=REPORT
=RESEM
=YNQ
@C.NUM@
@D.CAT.AUX@
@D.NUM.PL@
@D.NUM.SG@
@D.SI@
@D.VAL.BIGT@
@P.CAT.AUX@
@P.NUM.PL@
@P.NUM.SG@
@P.SI.1@
@P.SI.2@
@P.SI.3@
@P.VAL.BIGT@
@P.VAR.AE@
@P.VAR.GWIGU@
@P.VAR.HEHI@
@P.VAR.IMIX@
@P.VAR.XSKS@
@R.CAT.AUX@
ASSOC
AX
DIST
PL_
PN
PROX

LEXICON Root
RootNoun ;
RootTransitiveVerb ;
RootIntransitiveVerb ;
RootPreverb ;
RootModifier ;
RootAdverb ;
RootSubordinator ;
RootCommand ;
RootPrenoun ;
RootQuantifier ;
RootModal ;
RootAuxiliary ;
RootParticle ;
RootClauseModifier ;
RootNumber ;
RootAddressForm ;

LEXICON RootNoun
bil$aa 	Noun ;
g_alk_'$an 	Noun ;
dax_w$inst 	Noun ;
g_al$an 	Noun ;
h$a 	Noun ;
gip$aygunsxw 	Noun ;
l$uux 	Noun ;
'aml$uux 	Noun ;
g_an$a'lax_ 	Noun ;
j$agwasxw 	Noun ;
y$ajasxw 	Noun ;
k'aky'$otl' 	Noun ;
giky'$otl' 	Noun ;
h$ooni 	Noun ;
d$ilimx_xw 	Noun ;
sg_ansg_$ojinx_t 	Noun ;
'$on 	Noun ;
'an'$on 	Noun ;
t'imk_'$aax 	Noun ;
ts'imts'$anks 	Noun ;
haw$il 	Noun ;
'$aat 	Noun ;
g$um 	Noun ;
hahligy$ootxw 	Noun ;
hagy$ootxw 	Noun ;
haky'$o'o 	Noun ;
d$ihlxw 	Noun ;
'n$ax_ 	Noun ;
hl$it' 	Noun ;
h$oo'oxs 	Noun ;
'amh$oo'oxs 	Noun ;
m$aas 	Noun ;
w$ilph$abasxw 	Noun ;
m$oohl 	Noun ;
'n$oo'o 	Noun ;
hlgw$a'alt 	Noun ;
y$uusilt 	Noun ;
hay$ats 	Noun ;
gy$uu 	Noun ;
m$aa'y 	Noun ;
m$aa'yimsp$aaytg_an 	Noun ;
simsm$ax 	Noun ;
ts'im$ilix 	Noun ;
jay$aas 	Noun ;
b$iya 	Noun ;
b$an 	Noun ;
ts'$ok_' 	Noun ;
bil$an 	Noun ;
hlisd$o'oxs 	Noun ;
l$o'ob$a'on 	Noun ;
h$a'widing$a'lasxw 	Noun ;
haaw$ak_ 	Noun ;
ts'$uuts' 	Noun ;
g_$asx_ 	Noun ;
t'$uuts'xw 	Noun ;
t'$uuts'xwa 	Noun ;
'ax_g_ab$itxwt 	Noun ;
'anda'$is 	Noun ;
gwil$a 	Noun ;
gwiil$a 	Noun ;
'ihl$ee'e 	Noun ;
g_aw'ihl$ee'e 	Noun ;
'miy$ahl 	Noun ;
k_'alid$akhl 	Noun ;
t'aag_$an 	Noun ;
g_as'$uu 	Noun ;
s$ip 	Noun ;
sips$ip 	Noun ;
l$aal 	Noun ;
s'$in 	Noun ;
haxwd$akw 	Noun ;
w$o'os 	Noun ;
g_aw$o'os 	Noun ;
x_b$iist 	Noun ;
g_ax_b$iist 	Noun ;
'$ink_ 	Noun ;
gin$ees 	Noun ;
hak'$eeg_antxw 	Noun ;
ts'ixsn$a'ax_s 	Noun ;
wing_$es 	Noun ;
'an$ist 	Noun ;
'an$aax 	Noun ;
'm$oot'ixs 	Noun ;
g_an$eex_s 	Noun ;
hat'$uusxw 	Noun ;
l$ax_s 	Noun ;
ha'$aks 	Noun ;
g_$aldim$aks 	Noun ;
mask_'ay$aa'y 	Noun ;
'$ap 	Noun ;
t'imb$ok_' 	Noun ;
'm$ala'an 	Noun ;
'm$ala 	Noun ;
g_an'm$ala'an 	Noun ;
g_an'm$ala 	Noun ;
gw$iisg_an'm$ala'a 	Noun ;
gw$iisg_an'm$ala 	Noun ;
mask'aw$oodax_ 	Noun ;
g_anx_y$a'a 	Noun ;
hisb$iliks 	Noun ;
s$a'wnsxumhl$ox_s 	Noun ;
haguxwsg_alt'$amdinsxw 	Noun ;
'anj$ok_ 	Noun ;
gwisgw$oos 	Noun ;
l$aaxwsimh$ix 	Noun ;
k_'$aat' 	Noun ;
'm$al 	Noun ;
hu'm$al 	Noun ;
ts'il$aasxw 	Noun ;
wij$ix 	Noun ;
d$uus 	Noun ;
n$oosik_ 	Noun ;
sanakw$a 	Noun ;
hat'$a'l 	Noun ;
ma'$ulkw 	Noun ;
'amhat'$a'l 	Noun ;
'any$uust 	Noun ;
ha'niit'$aa 	Noun ;
t'$uuts' 	Noun ;
d$o'o 	Noun ;
k_'$uhlx_ 	Noun ;
sk'$iik 	Noun ;
sk'$ik' 	Noun ;
ts$igins 	Noun ;
mis'm$oot'ixs 	Noun ;
sim'$oogit 	Noun ;
simgig$at 	Noun ;
sigidimn$ak_' 	Noun ;
sigidimh$aanak_' 	Noun ;
hlgutk'$ihlxw 	Noun ;
hlgut'$ihlxw 	Noun ;
k'ubatk'$ihlxw 	Noun ;
k'ubat'$ihlxw 	Noun ;
g_anmi'$in 	Noun ;
k_'$ets' 	Noun ;
j$ayn 	Noun ;
haw$oonax_hlxw 	Noun ;
'miits'$ok_' 	Noun ;
d$aax 	Noun ;
ts'$ak_' 	Noun ;
ps$a 	Noun ;
ts'i'n$aast 	Noun ;
hahl$o'o 	Noun ;
haxh$ooyasxw 	Noun ;
ha'niil$isa 	Noun ;
y$een 	Noun ;
g_amt'$uuts' 	Noun ;
gwid$ats' 	Noun ;
g_$aldimx_c$offee 	Noun ;
g_$aldimx_k$opii 	Noun ;
'$eek_ 	Noun ;
gimil$ak 	Noun ;
w$it 	Noun ;
hapts'$a'y 	Noun ;
m$eek_ 	Noun ;
'$uuk_ 	Noun ;
hay$atsxw 	Noun ;
l$uulak_' 	Noun ;
'am'm$al 	Noun ;
h$abax_ 	Noun ;
'$usimsbaaytg_$an 	Noun ;
k_'alm$oos 	Noun ;
m$ilikst 	Noun ;
t'im$i'yt 	Noun ;
ts'id$ipxst 	Noun ;
sb$ikst 	Noun ;
g_ad$alk_ 	Noun ;
'ay$ukws 	Noun ;
g_awk_'$aw 	Noun ;
m$aa'yag_$aak_ 	Noun ;
sg_a'y$ag_a 	Noun ;
'andilg_$an 	Noun ;
s$a 	Noun ;
'mis$aax 	Noun ;
'mish$aax 	Noun ;
w$an 	Noun ;
hu'$ums 	Noun ;
'w$ums 	Noun ;
xsi'y$ans 	Noun ;
'miiw$inst 	Noun ;
limx'$oo'y 	Noun ;
ts'$eet'ixs 	Noun ;
ts'$ak' 	Noun ;
jits'$ak' 	Noun ;
jixts'$ak' 	Noun ;
'$us 	Noun ;
g_an$iis 	Noun ;
saabay$a'a 	Noun ;
'$aats'ip 	Noun ;
mixk_'$aax 	Noun ;
g$eets 	Noun ;
hay$ala 	Noun ;
'an$uuhl 	Noun ;
nax_n$aax_t 	Noun ;
m$ukw 	Noun ;
x_sg$aak 	Noun ;
lax_x_sg$iik 	Noun ;
sg$imsim 	Noun ;
m$uxw 	Noun ;
hum$uxw 	Noun ;
g_am$uxw 	Noun ;
g_ahum$uxw 	Noun ;
max_m$uxw 	Noun ;
laldimw$is 	Noun ;
hay$ook_xw 	Noun ;
ts'$ee 	Noun ;
l$ok_' 	Noun ;
hlgimh$a 	Noun ;
sg_$ans 	Noun ;
l$oots' 	Noun ;
sg_anl$oots' 	Noun ;
ts'$amtx 	Noun ;
gihl$ee'e 	Noun ;
ts'u'w$in 	Noun ;
y$uxwsa 	Noun ;
ts'$a'a 	Noun ;
lig$i'l 	Noun ;
layaw$oo'lip 	Noun ;
layaw$oo'mil 	Noun ;
xws$it 	Noun ;
wil'naat'$ahl 	Noun ;
h$ix 	Noun ;
l$i'ligit 	Noun ;
g_al$aax_an 	Noun ;
n$eek_' 	Noun ;
g_ats'uw$inilt 	Noun ;
g_$aak_ 	Noun ;
sg_$enx 	Noun ;
s$ilgunst 	Noun ;
sd$a'lixs 	Noun ;
w$ihl 	Noun ;
l$akw 	Noun ;
Gisk_'ah$aast 	Noun ;
Gisk_'$aast 	Noun ;
h$un 	Noun ;
h$on 	Noun ;
l$an 	Noun ;
'w$een 	Noun ;
g_alk_'$oop' 	Noun ;
t'a'wilt 	Noun ;
hl$atsx_ 	Noun ;
t'$in 	Noun ;
ha'niiw$an 	Noun ;
majag_al$ee 	Noun ;
biy$oosxw 	Noun ;
k'iphl$ik' 	Noun ;
x_$eek_ 	Noun ;
win$eex 	Noun ;
l$o'obimt'img_$es 	Noun ;
l$o'obats'$a'l 	Noun ;
m$iin 	Noun ;
nax_s'n$eex_ 	Noun ;
h$upx_ 	Noun ;
hax_sm$ax 	Noun ;
t'ak'al$uts 	Noun ;
k_'ala'w$aa'a 	Noun ;
ha'niixwsd$insa 	Noun ;
'ans$iip'insxw 	Noun ;
d$amk_xw 	Noun ;
g_an$aa'w 	Noun ;
lax_s$ee'l 	Noun ;
g_an$ada 	Noun ;
s$ox_ 	Noun ;
h$akwhl 	Noun ;
mihl$a 	Noun ;
d$ilksimxw 	Noun ;
'and$uuyn 	Noun ;
s'y$un 	Noun ;
g$ul 	Noun ;
h$abasxw 	Noun ;
k'ibil$ap 	Noun ;
'ansg$iyast 	Noun ;
t'$ilix 	Noun ;
l$itsxw 	Noun ;
max_m$eek_ 	Noun ;
bisd$a'y 	Noun ;
lik'$i'nsxw 	Noun ;
gw$iikw 	Noun ;
k'uuhlx_$an 	Noun ;
ha'niig_an'w$in 	Noun ;
dihlxumj$ayn 	Noun ;
hal$akw 	Noun ;
jax_ts'$ax_ 	Noun ;
g_$es 	Noun ;
ts'$al 	Noun ;
tx_$ox 	Noun ;
d$ak_hl 	Noun ;
g_$ayt 	Noun ;
g_ag_$ayt 	Noun ;
sg_ants'$ak' 	Noun ;
t'img_$es 	Noun ;
g_at'img_$es 	Noun ;
g_$oot 	Noun ;
g_ag_$oot 	Noun ;
d$ipx_s 	Noun ;
xs$uu'w 	Noun ;
'amg$iikw 	Noun ;
g$iikw 	Noun ;
sg$a 	Noun ;
halsg$it 	Noun ;
k_'$elt 	Noun ;
t'imk'$uukw' 	Noun ;
n$eek_ 	Noun ;
hasg_$altxw 	Noun ;
gyuwad$an 	Noun ;
gyuwad$antxw 	Noun ;
w$ilps$iipxw 	Noun ;
w$ilp 	Noun ;
huw$ilp 	Noun ;
sim'm$aa'y 	Noun ;
'miig_$an 	Noun ;
sdi'm$oon 	Noun ;
d$aw 	Noun ;
did$aw 	Noun ;
'aluug$at 	Noun ;
'aluugig$at 	Noun ;
hal$ayt 	Noun ;
haal$ayt 	Noun ;
ts'$ee'w 	Noun ;
h$aat 	Noun ;
lixst'$aa 	Noun ;
sgin$ist 	Noun ;
'amsgin$ist 	Noun ;
hlguy$a 	Noun ;
w$ilpdixl$ee'e 	Noun ;
jap$aan 	Noun ;
xb$aa'w 	Noun ;
x_b$aa'w 	Noun ;
willuuhiihly$ahlxw 	Noun ;
ts'$ex_ 	Noun ;
'anj$am 	Noun ;
'anjimj$am 	Noun ;
hak_'$ag_a 	Noun ;
k'its'$ee 	Noun ;
t'ak'its'$ee 	Noun ;
t'ab$ee'e 	Noun ;
'n$eex_hl 	Noun ;
ts'iy$oolik' 	Noun ;
k_'$esi 	Noun ;
'ming_an$eex_s 	Noun ;
t'$ax_ 	Noun ;
dit'$ax_ 	Noun ;
l$aaxws 	Noun ;
y$ip 	Noun ;
'$algax_ 	Noun ;
'ay$ook_ 	Noun ;
'y$ans 	Noun ;
m$at'ux$un 	Noun ;
s$e'e 	Noun ;
sis$e'e 	Noun ;
g_andid$ils 	Noun ;
h$u'max_ 	Noun ;
n$isx_ 	Noun ;
d$ap 	Noun ;
xs$ihlxw 	Noun ;
g_$ol 	Noun ;
t'$a 	Noun ;
'an$awhlxw 	Noun ;
w$eex 	Noun ;
sm$a'wn 	Noun ;
g$at 	Noun ;
'$ii'wxwt 	Noun ;
l$og_om'wiig$at 	Noun ;
k_'$oox_st 	Noun ;
h$at' 	Noun ;
hal$agumg_$an 	Noun ;
xwd$aa 	Noun ;
sm$ax 	Noun ;
hald$aakws 	Noun ;
x_ald$awk_xw 	Noun ;
hlbiy$umasxw 	Noun ;
s$ilkw 	Noun ;
nis'$in 	Noun ;
'anksul$aag_altxw 	Noun ;
m$andi 	Noun ;
d$aala 	Noun ;
hl$ox_sim$ax_xw 	Noun ;
x_ad$aa 	Noun ;
hliy$un 	Noun ;
h$iihluxw 	Noun ;
'$umhl 	Noun ;
majil$uulak_' 	Noun ;
sg_a'n$ist 	Noun ;
sixsg_a'n$ist 	Noun ;
m$atx 	Noun ;
haw$aw 	Noun ;
d$uusimgil$ilix 	Noun ;
dib$e 	Noun ;
dib$oogit 	Noun ;
ts'im$aak_ 	Noun ;
g_ats'im$aak_ 	Noun ;
'$aak_ 	Noun ;
s$axw 	Noun ;
tl'$ook' 	Noun ;
nak_'$eeda 	Noun ;
g$als 	Noun ;
'ad$aawk_ 	Noun ;
t'$aapx_ansxw 	Noun ;
hl$ak_s 	Noun ;
hl$ax_s 	Noun ;
w$a 	Noun ;
huw$a 	Noun ;
lax_d$ibilx 	Noun ;
t'$ikw' 	Noun ;
t'iml$anix 	Noun ;
'$iis 	Noun ;
s$ee'lax_ 	Noun ;
gwi'n$us 	Noun ;
'n$usik 	Noun ;
'$ax_xw 	Noun ;
majily$ee 	Noun ;
g_al$amk_ 	Noun ;
silkws$ax_ 	Noun ;
gits'$ook_ 	Noun ;
ts'$ak_ 	Noun ;
jax_ts'$ak_ 	Noun ;
ts'imts'$ak_ 	Noun ;
lax_s$iilda 	Noun ;
lax_m$o'on 	Noun ;
h$aykw 	Noun ;
l$og_om'wiig$at 	Noun ;
log_om'wiin$ak_' 	Noun ;
s$aak 	Noun ;
wilpkw'$ats 	Noun ;
k'utk'u'n$uxs 	Noun ;
g_anw$alix 	Noun ;
w$aax 	Noun ;
dab$oon 	Noun ;
t'ab$oon 	Noun ;
ts'im$un 	Noun ;
'm$ax_s 	Noun ;
maa'm$ax_s 	Noun ;
s$a'wnsxw 	Noun ;
g_ant'im$is 	Noun ;
ts'$ap 	Noun ;
ha'm$ats 	Noun ;
halimwil'$aat 	Noun ;
guxwsg_alt'$amdinsxw 	Noun ;
k_'$ap 	Noun ;
ha'm$ahl'i 	Noun ;
hax_mi'y$an 	Noun ;
sg$an 	Noun ;
hahl$ibisxw 	Noun ;
'anduw$oot' 	Noun ;
'maaslik'$i'nsxw 	Noun ;
'amk_'$ooxst 	Noun ;
'$axwt 	Noun ;
sgus$iit 	Noun ;
sus$iit 	Noun ;
suus$iit 	Noun ;
y$ukw 	Noun ;
b$aahlats 	Noun ;
lax_'am$aaxws 	Noun ;
libl$eet 	Noun ;
hlguw$ilksihlxw 	Noun ;
k'ubaw$ilksihlxw 	Noun ;
'$ee'esxw 	Noun ;
'ay'$aa'y 	Noun ;
'm$o'oxw 	Noun ;
'$andahaw$il 	Noun ;
g_$ax_ 	Noun ;
ha'$algag_amg_al'$ink_ 	Noun ;
sax_sg_$an 	Noun ;
hag$imgasxw 	Noun ;
w$is 	Noun ;
max_m$aag_ay 	Noun ;
n$aasik' 	Noun ;
g_$aakhl 	Noun ;
has$eex 	Noun ;
g_$aak_ 	Noun ;
simg_$an 	Noun ;
h$aa'atx 	Noun ;
k_'$ap 	Noun ;
g_apk_'$apxw 	Noun ;
ha'm$ook_ 	Noun ;
pd$al 	Noun ;
miy$up 	Noun ;
k_'abal$uu 	Noun ;
'abal$uu 	Noun ;
sim$un 	Noun ;
ts'ixsda'un 	Noun ;
g_$enx_ 	Noun ;
g_ang_$enx_ 	Noun ;
gwisg_angw$a'ltxw 	Noun ;
sg_angw$a'ltxw 	Noun ;
l$o'op 	Noun ;
g_ambuxw 	Noun ;
w$ist 	Noun ;
'$ax_ 	Noun ;
hagwil$uxw 	Noun ;
k_'$ok_hl 	Noun ;
l$aam 	Noun ;
y$ahlx_ 	Noun ;
m$o'on 	Noun ;
'miik_'$oox_st 	Noun ;
xs$iip 	Noun ;
w$isax 	Noun ;
g$am 	Noun ;
sg_ang$am 	Noun ;
ha'niiy$eek_ 	Noun ;
hax_b$eex_sxw 	Noun ;
'am$alkw 	Noun ;
g_$olix 	Noun ;
h$it' 	Noun ;
hith$it' 	Noun ;
phl$o'on 	Noun ;
hlak_'$asxw 	Noun ;
hl$a'asxw 	Noun ;
hlak_'$ahasxw 	Noun ;
'anw$ana'a 	Noun ;
hal$ibast 	Noun ;
g_ans'oots'x_$an 	Noun ;
g_ansk_'oots'x_$an 	Noun ;
t'imhl$aa'm 	Noun ;
xhl$a'wsxw 	Noun ;
ts'$a'wax_s 	Noun ;
n$o'ohl 	Noun ;
hin$o'ohl 	Noun ;
hats'$al 	Noun ;
pd$oohl 	Noun ;
g_$aakw 	Noun ;
xs$an 	Noun ;
tk_'$a 	Noun ;
dax_tk_'$a 	Noun ;
n$imk_ 	Noun ;
n$ak_' 	Noun ;
nax_n$ak_' 	Noun ;
t'amilw$ilgit 	Noun ;
g_$en 	Noun ;
lax_h$a 	Noun ;
lax_$a 	Noun ;
x_$a'a 	Noun ;
hlihl$ingit 	Noun ;
w$at'uxw 	Noun ;
hlihl$ingit 	Noun ;
kw'$aat'ax_ 	Noun ;
mi'$in 	Noun ;
h$uxws 	Noun ;
w$ilpsih$un 	Noun ;
l$alt 	Noun ;
h$ogwast 	Noun ;
n$uts' 	Noun ;
m$aadim 	Noun ;
m$aaxws 	Noun ;
ts'$iihl 	Noun ;
n$ax_ 	Noun ;
m$aaxwsxumg_$ax_ 	Noun ;
gw$ilt 	Noun ;
hay$o'oxs'$untxw 	Noun ;
'$is 	Noun ;
sg_an$is 	Noun ;
mis$o'o 	Noun ;
g$itl' 	Noun ;
dahl$iisx 	Noun ;
l$imx 	Noun ;
'$oots'in 	Noun ;
gadal$ee 	Noun ;
t'imwilky'$o'o 	Noun ;
h$oobix 	Noun ;
k_'alduux 	Noun ;
g_al$aak_' 	Noun ;
gw$anks 	Noun ;
y$a'a 	Noun ;
gw$ooyim 	Noun ;
s$eek_s 	Noun ;
hl$oox_ 	Noun ;
ts'inhl$ik' 	Noun ;
bil'$ust 	Noun ;
bixbil'$ust 	Noun ;
g_asg_$aats 	Noun ;
mil$it 	Noun ;
gil$an 	Noun ;
sd$atxs 	Noun ;
g_al'$oost 	Noun ;
sd$uup 	Noun ;
g_aldimw$oot' 	Noun ;
'ant'im$ahlasxw 	Noun ;
'miig$unt 	Noun ;
'miid$oots' 	Noun ;
sugw$a 	Noun ;
s$int 	Noun ;
hl$ok_s 	Noun ;
hl$ox_s 	Noun ;
ha'niisgw$aa'ytxw 	Noun ;
ha'niig_an$uutxw 	Noun ;
hasiy$ayks 	Noun ;
dilg_$og_a 	Noun ;
'angux'$uutxw 	Noun ;
ha'niitx_$ook_xw 	Noun ;
k'$uukw' 	Noun ;
k'$eex 	Noun ;
x_d$ii 	Noun ;
g_aldimx_d$ii 	Noun ;
gip$aygum$algax_ 	Noun ;
haluu'$algag_amt'$uuts'xw 	Noun ;
haluum$ahlasxumt'$uuts'xw 	Noun ;
l$iluxws 	Noun ;
g_al$iluxws 	Noun ;
b$a'a 	Noun ;
sg_anh$ahl 	Noun ;
g_anx_l$ibast 	Noun ;
nisk_'$o'o 	Noun ;
ha'niig_$oot 	Noun ;
sn$ax_ 	Noun ;
sn$ahat 	Noun ;
sn$aat 	Noun ;
sg_ansn$ax_ 	Noun ;
sg_ansn$ahat 	Noun ;
sg_ansn$aat 	Noun ;
g_anl$ip'insxw 	Noun ;
m$oos 	Noun ;
ty$a'ytxw 	Noun ;
tye'$etxw 	Noun ;
ha'niitx_$alpx_sa 	Noun ;
mi'y$an 	Noun ;
hapts'$eek_xw 	Noun ;
d$ilx_ 	Noun ;
g_ad$ilx_ 	Noun ;
'anh$ooya 	Noun ;
'an$ooya 	Noun ;
'anhaxh$ooya 	Noun ;
'w$in 	Noun ;
win'w$in 	Noun ;
hay$o'oxs'w$intxw 	Noun ;
lax_$u 	Noun ;
xwts'$aan 	Noun ;
pts'$aan 	Noun ;
j$ap 	Noun ;
jay$eehl 	Noun ;
siil$inasxw 	Noun ;
g_$an 	Noun ;
g_ang_$an 	Noun ;
pd$eek_ 	Noun ;
l$aaxw 	Noun ;
ha'niig$ilbilsa 	Noun ;
hl$axw 	Noun ;
luuhli'm$ax_s 	Noun ;
luuhlixhl$a'wsxw 	Noun ;
gig$eenix 	Noun ;
t'$in 	Noun ;
g_alts'$ap 	Noun ;
ts'ixts'$ik' 	Noun ;
h$aahlx_an 	Noun ;
has$ak_ 	Noun ;
l$uxw 	Noun ;
'$aks 	Noun ;
ts'$itxs 	Noun ;
miks$ihl 	Noun ;
muxs$ihl 	Noun ;
l$it 	Noun ;
lil$it 	Noun ;
ha'niigwil$a'lsa 	Noun ;
'agw$i 	Noun ;
'ag$u 	Noun ;
gw$i 	Noun ;
g$u 	Noun ;
daasgan 	Noun ;
ts'$a'lixs 	Noun ;
'y$imk 	Noun ;
hax_sgw$iikws 	Noun ;
'maas$ol 	Noun ;
hl$oots' 	Noun ;
'amksiw$aa 	Noun ;
k_'amksiw$aa 	Noun ;
'amxsiw$aa 	Noun ;
n$aa 	Noun ;
ts'insj$akw 	Noun ;
'am'w$aasan 	Noun ;
g$iis 	Noun ;
x_hl$aahl 	Noun ;
b$ahasxw 	Noun ;
b$aasxw 	Noun ;
tk'uts'$ilksxw 	Noun ;
'aluug_$oyp'ax_ 	Noun ;
g_al'am$e 	Noun ;
k_'$aax 	Noun ;
hald$awgit 	Noun ;
gib$uu 	Noun ;
lax_gib$uu 	Noun ;
naag_$ets 	Noun ;
han$ak_' 	Noun ;
haan$ak_' 	Noun ;
'ansg$imhlxw 	Noun ;
gihl'w$intsxw 	Noun ;
gihl'w$insxw 	Noun ;
gil$ilix 	Noun ;
wilpl$akw 	Noun ;
ha'niij$ok_ 	Noun ;
ts'it'$uxsda 	Noun ;
ham$om 	Noun ;
k'$uuhl 	Noun ;
guhlk'$uuhl 	Noun ;
niy$e'e 	Noun ;
g_aniy$e'etxw 	Noun ;
nits'$iits' 	Noun ;
g_anits'$iits'xw 	Noun ;
nigw$oot 	Noun ;
g_anigw$ootxw 	Noun ;
b$aap 	Noun ;
n$ox_ 	Noun ;
g_an$oonax_ 	Noun ;
n$aa'a 	Noun ;
nib$ip 	Noun ;
nixd$aa 	Noun ;
k_'ahl$aan 	Noun ;
w$ak 	Noun ;
xhlg$iikw 	Noun ;
gimxd$i 	Noun ;
gutx_a'$oo 	Noun ;
hlg$uuhlxw 	Noun ;
hlg$i 	Noun ;
hlguuhlxumg$at 	Noun ;
hlguuhlxumhan$ak_' 	Noun ;
gusl$is 	Noun ;
huxwd$aak'in 	Noun ;
guxwd$aak'in 	Noun ;
n$aks 	Noun ;
n$iinixsxw 	Noun ;
g_an$iinixs 	Noun ;
hl$ams 	Noun ;
hlihl$amsxw 	Noun ;
g_ahl$amsxw 	Noun ;
ky'$ootxs 	Noun ;
gwij$iis 	Noun ;
wil$aayasxw 	Noun ;
'anl$i'ligit 	Noun ;
t$oost 	Noun ;
g_ad$o'o 	Noun ;
t'ilx_$oo 	Noun ;
Gitxs$an 	Noun ;
Ts'ims$an 	Noun ;
did$ils 	Noun ;
g_an$uutxw 	Noun ;
sb$ag_aytg_$an 	Noun ;
sdik'$eekw 	Noun ;
sw$it 	Noun ;
g_ad$aax 	Noun ;
'ants'$ap 	Noun ;
'anjipts'$ap 	Noun ;
tk'$ihlxw 	Noun ;
t'$ihlxw 	Noun ;
'$aatyasxw 	Noun ;
b$ukw 	Noun ;
'ang$a'la 	Noun ;
lax_y$ip 	Noun ;
sag_$ootxw 	Noun ;
t'$uu'w 	Noun ;
x_sd$altxw 	Noun ;
'anhahl$a'lst 	Noun ;
ha'niiy$o'oxsxw 	Noun ;
'an'$ixw 	Noun ;
'esdiw$aal 	Noun ;
m$ihlasxw 	Noun ;
'anda'$uut 	Noun ;
hligw$i 	Noun ;
hab$ahlx_anasxw 	Noun ;
s$iipxumhl$ox_s 	Noun ;
g_as$eexw 	Noun ;
'ansah$un 	Noun ;
'ansiil$inasxw 	Noun ;
'ansim$aa'y 	Noun ;
'ansa'an$aax 	Noun ;

LEXICON Noun

LEXICON RootTransitiveVerb
da'$ak_hlxw 	TransitiveVerb ;
da'$ak_xw 	TransitiveVerb ;
sd$il 	TransitiveVerb ;
y$uuhlimxw 	TransitiveVerb ;
y$uuhlimx_ 	TransitiveVerb ;
g$idax_ 	TransitiveVerb ;
gig$idax_ 	TransitiveVerb ;
gwi'n$a 	TransitiveVerb ;
gwii'n$a 	TransitiveVerb ;
'$uut 	TransitiveVerb ;
simh$etxws 	TransitiveVerb ;
hl$ak 	TransitiveVerb ;
hl$iihlik 	TransitiveVerb ;
@P.VAL.BIGT@h$ats'T 	TransitiveVerb ;
@P.VAL.BIGT@hash$ats'T 	TransitiveVerb ;
gw$aasxwt 	TransitiveVerb ;
dag_$osasxw 	TransitiveVerb ;
dag_$asg_osasxw 	TransitiveVerb ;
'ihl$ag_an 	TransitiveVerb ;
sim$ihl 	TransitiveVerb ;
g$iikw 	TransitiveVerb ;
'm$ukw 	TransitiveVerb ;
k_'$eeg_an 	TransitiveVerb ;
h$uudin 	TransitiveVerb ;
g_$e'n 	TransitiveVerb ;
@P.VAL.BIGT@t'$ok_T 	TransitiveVerb ;
k_'$alt 	TransitiveVerb ;
'minpd$altxw 	TransitiveVerb ;
sg_at'$is 	TransitiveVerb ;
'$ankwsin 	TransitiveVerb ;
j$am 	TransitiveVerb ;
jimj$am 	TransitiveVerb ;
sigwin$eek_xw 	TransitiveVerb ;
h$ogax_ 	TransitiveVerb ;
h$ugwax_ 	TransitiveVerb ;
l$itsx_ 	TransitiveVerb ;
h$apt 	TransitiveVerb ;
dim$ootxw 	TransitiveVerb ;
k_'$ots 	TransitiveVerb ;
g_ask_'$ots 	TransitiveVerb ;
'$umk_xw 	TransitiveVerb ;
w$ok_' 	TransitiveVerb ;
x_s$ink_ 	TransitiveVerb ;
g_asg_$ootxw 	TransitiveVerb ;
@P.VAL.BIGT@k_'$aax_T 	TransitiveVerb ;
la'$aks 	TransitiveVerb ;
t'ugw$andin 	TransitiveVerb ;
g$up 	TransitiveVerb ;
gipg$up 	TransitiveVerb ;
j$ahl 	TransitiveVerb ;
jisj$ahl 	TransitiveVerb ;
l$aalax_ 	TransitiveVerb ;
b$aasx 	TransitiveVerb ;
y$oog_an 	TransitiveVerb ;
tx_$oog_an 	TransitiveVerb ;
'$aatx 	TransitiveVerb ;
g_$enin 	TransitiveVerb ;
l$inin 	TransitiveVerb ;
m$idin 	TransitiveVerb ;
'w$a 	TransitiveVerb ;
'w$eek_'s 	TransitiveVerb ;
hl$isin 	TransitiveVerb ;
hlixhl$isin 	TransitiveVerb ;
y$uxw 	TransitiveVerb ;
hat'$ag_an 	TransitiveVerb ;
t'$ak 	TransitiveVerb ;
sid$aw 	TransitiveVerb ;
gi'n$am 	TransitiveVerb ;
g$in 	TransitiveVerb ;
ging$in 	TransitiveVerb ;
s$uut 	TransitiveVerb ;
h$uksin 	TransitiveVerb ;
y$ukwsin 	TransitiveVerb ;
nax_'n$i 	TransitiveVerb ;
lax_'n$i 	TransitiveVerb ;
sig$amk 	TransitiveVerb ;
siliml$amk 	TransitiveVerb ;
hlim$oo 	TransitiveVerb ;
y$ats 	TransitiveVerb ;
yisy$ats 	TransitiveVerb ;
hisy$ats 	TransitiveVerb ;
'm$ats 	TransitiveVerb ;
mis'm$ats 	TransitiveVerb ;
@P.VAL.BIGT@dax_y$ukwT 	TransitiveVerb ;
d$a'mas 	TransitiveVerb ;
hlbiy$uxw 	TransitiveVerb ;
@P.VAL.BIGT@j$akwT 	TransitiveVerb ;
wil$aax 	TransitiveVerb ;
ts'$ahlx_xw 	TransitiveVerb ;
'ay$ook_ 	TransitiveVerb ;
d$ee'ntxw 	TransitiveVerb ;
siwil$aaks 	TransitiveVerb ;
@P.VAL.BIGT@m$ak_T 	TransitiveVerb ;
@P.VAL.BIGT@t'$ahlT 	TransitiveVerb ;
@P.VAL.BIGT@gw$aasT 	TransitiveVerb ;
ts'$eek_ 	TransitiveVerb ;
@P.VAL.BIGT@b$atsT 	TransitiveVerb ;
@P.VAL.BIGT@bisb$atsT 	TransitiveVerb ;
s$iip'in 	TransitiveVerb ;
sg_at'$akw 	TransitiveVerb ;
did$i'y 	TransitiveVerb ;
dixdid$i'y 	TransitiveVerb ;
@P.VAL.BIGT@l$aag_alT 	TransitiveVerb ;
@P.VAL.BIGT@lax_l$aag_alT 	TransitiveVerb ;
kw'$oodin 	TransitiveVerb ;
j$ap 	TransitiveVerb ;
jipj$ap 	TransitiveVerb ;
n$aksxw 	TransitiveVerb ;
j$ilksin 	TransitiveVerb ;
suug$att 	TransitiveVerb ;
sg$i 	TransitiveVerb ;
d$ox_ 	TransitiveVerb ;
@P.VAL.BIGT@k_'$ak_T 	TransitiveVerb ;
k_'$ak_ 	TransitiveVerb ;
b$aa'lax_t 	TransitiveVerb ;
w$alix 	TransitiveVerb ;
x_hlg_$o'o 	TransitiveVerb ;
x_$o'o 	TransitiveVerb ;
'an$ook_ 	TransitiveVerb ;
g_$aak_t 	TransitiveVerb ;
@P.VAL.BIGT@g_$atsT 	TransitiveVerb ;
@P.VAL.BIGT@g_asg_$atsT 	TransitiveVerb ;
d$amg_an 	TransitiveVerb ;
did$amg_an 	TransitiveVerb ;
t'$is 	TransitiveVerb ;
dist'$is 	TransitiveVerb ;
'm$alkw 	TransitiveVerb ;
tx_$alt 	TransitiveVerb ;
l$uxwt 	TransitiveVerb ;
@P.VAL.BIGT@'amg_$ooT 	TransitiveVerb ;
y$aldin 	TransitiveVerb ;
y$oot 	TransitiveVerb ;
xhlih$aks 	TransitiveVerb ;
xhlihaxh$aks 	TransitiveVerb ;
g_$aap 	TransitiveVerb ;
g_apg_$aap 	TransitiveVerb ;
g$a'a 	TransitiveVerb ;
gixg$a'a 	TransitiveVerb ;
@P.VAL.BIGT@w$oot'T 	TransitiveVerb ;
h$ets 	TransitiveVerb ;
hash$ets 	TransitiveVerb ;
daasgant 	TransitiveVerb ;
g$uxw 	TransitiveVerb ;
guxwg$uxw 	TransitiveVerb ;
ts'$o'ot 	TransitiveVerb ;
@P.VAL.BIGT@han$eek_T 	TransitiveVerb ;
y$im 	TransitiveVerb ;
hisy$atst 	TransitiveVerb ;
b$asig_an 	TransitiveVerb ;
bisb$asig_an 	TransitiveVerb ;
b$ahlx_an 	TransitiveVerb ;
bihlb$ahlx_an 	TransitiveVerb ;
h$edin 	TransitiveVerb ;
h$idin 	TransitiveVerb ;
l$idin 	TransitiveVerb ;
@P.VAL.BIGT@g$uuT 	TransitiveVerb ;
d$ok_ 	TransitiveVerb ;
did$alk_ 	TransitiveVerb ;
sa'amag$at 	TransitiveVerb ;
d$ilax_t 	TransitiveVerb ;
b$is 	TransitiveVerb ;
bisb$is 	TransitiveVerb ;
@P.VAL.BIGT@m$ahlT 	TransitiveVerb ;
ts'$iip 	TransitiveVerb ;
@P.VAL.BIGT@ts'$iipxwT 	TransitiveVerb ;
d$as 	TransitiveVerb ;
b$ak_ 	TransitiveVerb ;
h$oox 	TransitiveVerb ;
gib$a 	TransitiveVerb ;
gy$uksin 	TransitiveVerb ;
lug$uxsin 	TransitiveVerb ;
l$ak_s 	TransitiveVerb ;
l$aalax_s 	TransitiveVerb ;
y$o'oxs 	TransitiveVerb ;
hiy$o'oxs 	TransitiveVerb ;
hlim$oo'lt 	TransitiveVerb ;
@P.VAL.BIGT@siw$aT 	TransitiveVerb ;
dits'$in 	TransitiveVerb ;
diy$ee 	TransitiveVerb ;
@P.VAL.BIGT@y$ukwT 	TransitiveVerb ;
did$aa'whl 	TransitiveVerb ;
sit'$aa 	TransitiveVerb ;
siw$an 	TransitiveVerb ;
gwalx_y$ee'ns 	TransitiveVerb ;
@P.VAL.BIGT@sity$eexwT 	TransitiveVerb ;
@P.VAL.BIGT@luusity$eexwT 	TransitiveVerb ;
@P.VAL.BIGT@disity$eexwT 	TransitiveVerb ;
s$ibin 	TransitiveVerb ;
luus$ibin 	TransitiveVerb ;
'$is 	TransitiveVerb ;
'nii$is 	TransitiveVerb ;
sag_aytg_$oodin 	TransitiveVerb ;
@P.VAL.BIGT@'niit'$aaT 	TransitiveVerb ;
@P.VAL.BIGT@'niiw$anT 	TransitiveVerb ;
luuh$ugwag_an 	TransitiveVerb ;
kw'$asin 	TransitiveVerb ;
@P.VAL.BIGT@gung$a'aT 	TransitiveVerb ;
'm$its'in 	TransitiveVerb ;
'w$its'in 	TransitiveVerb ;
si'm$as 	TransitiveVerb ;
sil$imx_s 	TransitiveVerb ;
lis$eexw 	TransitiveVerb ;
sg_ah$it'in 	TransitiveVerb ;
h$it'in 	TransitiveVerb ;
dah$a'w 	TransitiveVerb ;
'$uu'w 	TransitiveVerb ;
@P.VAL.BIGT@t'$aaT 	TransitiveVerb ;
t'$am 	TransitiveVerb ;
sil$imx 	TransitiveVerb ;
g$i'y 	TransitiveVerb ;
y$eex_s 	TransitiveVerb ;
b$a 	TransitiveVerb ;
gy$ootxw 	TransitiveVerb ;
@P.VAL.BIGT@wil$aakwT 	TransitiveVerb ;
diy$altxw 	TransitiveVerb ;
g_$os 	TransitiveVerb ;
hl$o'otxw 	TransitiveVerb ;
luuhl$o'otxw 	TransitiveVerb ;
tw$a'lixs 	TransitiveVerb ;
da'w$itxw 	TransitiveVerb ;
dib$akw 	TransitiveVerb ;
'wii'$u 	TransitiveVerb ;
gwis$eek_ 	TransitiveVerb ;
gwiis$eek_ 	TransitiveVerb ;
'm$an 	TransitiveVerb ;
t'$ak'in 	TransitiveVerb ;
@P.VAL.BIGT@x_hlaam$ak_T 	TransitiveVerb ;
@P.VAL.BIGT@x_hlaat'$ahlT 	TransitiveVerb ;

LEXICON TransitiveVerb

LEXICON RootIntransitiveVerb
b$an 	IntransitiveVerb ;
binb$an 	IntransitiveVerb ;
x_pts'$axw 	IntransitiveVerb ;
lax_bits'$iixw 	IntransitiveVerb ;
did$ils 	IntransitiveVerb ;
dild$ils 	IntransitiveVerb ;
'$a'lax_ 	IntransitiveVerb ;
d$ilimx_xw 	IntransitiveVerb ;
'w$itxw 	IntransitiveVerb ;
b$akw 	IntransitiveVerb ;
l$akw 	IntransitiveVerb ;
m$ats 	IntransitiveVerb ;
hat'$ak_xw 	IntransitiveVerb ;
hadit'$ak_xw 	IntransitiveVerb ;
'naag_$akw 	IntransitiveVerb ;
'naahl$eek_ 	IntransitiveVerb ;
w$ox_ 	IntransitiveVerb ;
g_aw$ox_ 	IntransitiveVerb ;
wox_w$ox_ 	IntransitiveVerb ;
x_ts'$eekst 	IntransitiveVerb ;
t'$is 	IntransitiveVerb ;
dist'$is 	IntransitiveVerb ;
'wiihil$a'y 	IntransitiveVerb ;
'wit'ax_hil$a'y 	IntransitiveVerb ;
t'$ixw 	IntransitiveVerb ;
dit'$ixw 	IntransitiveVerb ;
dixwt'$ixw 	IntransitiveVerb ;
h$a'widing$a'lasxw 	IntransitiveVerb ;
g_$asx_ 	IntransitiveVerb ;
t'$uuts'xw 	IntransitiveVerb ;
dist'$uuts'xw 	IntransitiveVerb ;
s$ins 	IntransitiveVerb ;
'ihl$ee'e 	IntransitiveVerb ;
sw$an 	IntransitiveVerb ;
bil$utxw 	IntransitiveVerb ;
gwisgw$oosxw 	IntransitiveVerb ;
m$ak_xw 	IntransitiveVerb ;
maam$ax_xw 	IntransitiveVerb ;
hl$ut'ax_ 	IntransitiveVerb ;
g$at 	IntransitiveVerb ;
gig$at 	IntransitiveVerb ;
xsin$aahlx_ 	IntransitiveVerb ;
g_$oyp'ax_ 	IntransitiveVerb ;
'wii$ooks 	IntransitiveVerb ;
@P.VAL.BIGT@'ihl$ak_T 	IntransitiveVerb ;
'ihl$aahlax_t 	IntransitiveVerb ;
@P.VAL.BIGT@'ihl$aahlax_T 	IntransitiveVerb ;
@P.VAL.BIGT@kw'$asT 	IntransitiveVerb ;
m$ihl 	IntransitiveVerb ;
mihlm$ihl 	IntransitiveVerb ;
j$ibilixs 	IntransitiveVerb ;
x_hl$uxw 	IntransitiveVerb ;
g_ax_hl$uxw 	IntransitiveVerb ;
'$itxw 	IntransitiveVerb ;
'$etxw 	IntransitiveVerb ;
j$ok_ 	IntransitiveVerb ;
jax_j$ok_ 	IntransitiveVerb ;
ts'$iipxw 	IntransitiveVerb ;
s$aksxw 	IntransitiveVerb ;
sixs$aksxw 	IntransitiveVerb ;
x_$atxw 	IntransitiveVerb ;
gwin$eek_xw 	IntransitiveVerb ;
'$aat'ixs 	IntransitiveVerb ;
'at-$aat'ixs 	IntransitiveVerb ;
guxws$itxws 	IntransitiveVerb ;
'$ankws 	IntransitiveVerb ;
h$ogax_ 	IntransitiveVerb ;
h$ugwax_ 	IntransitiveVerb ;
x_l$ilst 	IntransitiveVerb ;
l$itsx_xw 	IntransitiveVerb ;
s$eeg_atxw 	IntransitiveVerb ;
'mal$u 	IntransitiveVerb ;
'mag_al$u 	IntransitiveVerb ;
hl$ak 	IntransitiveVerb ;
hl$iihlak 	IntransitiveVerb ;
'aph$etxw 	IntransitiveVerb ;
m$ootxw 	IntransitiveVerb ;
sa'$oohlxw 	IntransitiveVerb ;
m$iiluxw 	IntransitiveVerb ;
hal$ayt 	IntransitiveVerb ;
sk_'$eex_xw 	IntransitiveVerb ;
d$ok_' 	IntransitiveVerb ;
dax_d$ok_' 	IntransitiveVerb ;
hl$ap 	IntransitiveVerb ;
hliphl$ap 	IntransitiveVerb ;
'n$u'w 	IntransitiveVerb ;
d$axw 	IntransitiveVerb ;
lixsg$at 	IntransitiveVerb ;
g_$etxw 	IntransitiveVerb ;
g_ag_$etxw 	IntransitiveVerb ;
w$ok_'esxw 	IntransitiveVerb ;
ts'$eet'ixs 	IntransitiveVerb ;
jits'$eet'ixs 	IntransitiveVerb ;
t'$aks 	IntransitiveVerb ;
tk'is$aks 	IntransitiveVerb ;
b$itxw 	IntransitiveVerb ;
xsiw$ok_ 	IntransitiveVerb ;
'ay$ukwsxw 	IntransitiveVerb ;
n$uutxw 	IntransitiveVerb ;
haxh$ooyasxw 	IntransitiveVerb ;
g_an$uutxw 	IntransitiveVerb ;
s$il 	IntransitiveVerb ;
sils$il 	IntransitiveVerb ;
gw$alkw 	IntransitiveVerb ;
gwilgw$alkw 	IntransitiveVerb ;
x_d$eek_ 	IntransitiveVerb ;
'm$itxw 	IntransitiveVerb ;
hl$ook_ 	IntransitiveVerb ;
hlax_hl$ook_ 	IntransitiveVerb ;
y$ook_xw 	IntransitiveVerb ;
tx_$ook_xw 	IntransitiveVerb ;
t'$eek_ 	IntransitiveVerb ;
lit'$eek_ 	IntransitiveVerb ;
ts'$in 	IntransitiveVerb ;
ts'imax_s 	IntransitiveVerb ;
b$isxw 	IntransitiveVerb ;
mag_$oonsxw 	IntransitiveVerb ;
g_$enx_ 	IntransitiveVerb ;
l$inx_ 	IntransitiveVerb ;
tk_'aakw'$adixsxw 	IntransitiveVerb ;
g$uwasxw 	IntransitiveVerb ;
guxwg$uwasxw 	IntransitiveVerb ;
t'ugw$antxw 	IntransitiveVerb ;
'm$asxw 	IntransitiveVerb ;
mis'm$asxw 	IntransitiveVerb ;
n$aahlx_ 	IntransitiveVerb ;
t'$ee'lt 	IntransitiveVerb ;
h$ix 	IntransitiveVerb ;
sb$ax_sxw 	IntransitiveVerb ;
d$al 	IntransitiveVerb ;
'$awsxw 	IntransitiveVerb ;
hl$isxw 	IntransitiveVerb ;
hlixhl$isxw 	IntransitiveVerb ;
xsg_$ook_ 	IntransitiveVerb ;
'$ixw 	IntransitiveVerb ;
gy$ooks 	IntransitiveVerb ;
l$ooks 	IntransitiveVerb ;
gip$aykw 	IntransitiveVerb ;
lip$aykw 	IntransitiveVerb ;
m$omst 	IntransitiveVerb ;
m$itxw 	IntransitiveVerb ;
mitm$itxw 	IntransitiveVerb ;
ts'$eex 	IntransitiveVerb ;
m$amst 	IntransitiveVerb ;
h$akhlxw 	IntransitiveVerb ;
x_s$an 	IntransitiveVerb ;
gi'n$itxw 	IntransitiveVerb ;
li'n$idimax_s 	IntransitiveVerb ;
y$ee 	IntransitiveVerb ;
hlo'o 	IntransitiveVerb ;
wilax_s 	IntransitiveVerb ;
xs$axw 	IntransitiveVerb ;
xs$eek_ 	IntransitiveVerb ;
ts'$ak 	IntransitiveVerb ;
'$am 	IntransitiveVerb ;
'am'$am 	IntransitiveVerb ;
mihl$atxw 	IntransitiveVerb ;
k_'$esx 	IntransitiveVerb ;
'm$as 	IntransitiveVerb ;
l$imax_s 	IntransitiveVerb ;
l$imx_s 	IntransitiveVerb ;
g_$antxw 	IntransitiveVerb ;
g_ang_$antxw 	IntransitiveVerb ;
x_as$iipsxws 	IntransitiveVerb ;
sd$in 	IntransitiveVerb ;
sankw'$ax_ 	IntransitiveVerb ;
y$axw 	IntransitiveVerb ;
hil$iixw 	IntransitiveVerb ;
n$o'o 	IntransitiveVerb ;
n$oona'a 	IntransitiveVerb ;
h$a'w 	IntransitiveVerb ;
g$amk 	IntransitiveVerb ;
l$amk 	IntransitiveVerb ;
xwd$ax 	IntransitiveVerb ;
luxwd$ax 	IntransitiveVerb ;
t'$ee'esxw 	IntransitiveVerb ;
s$iipxw 	IntransitiveVerb ;
sips$iipxw 	IntransitiveVerb ;
sg_$eksxw 	IntransitiveVerb ;
d$aw 	IntransitiveVerb ;
did$aw 	IntransitiveVerb ;
hax_hamdak_xw 	IntransitiveVerb ;
x_ts'$ak_xw 	IntransitiveVerb ;
g$asxw 	IntransitiveVerb ;
gisg$asxw 	IntransitiveVerb ;
skw'$atxw 	IntransitiveVerb ;
gy$uks 	IntransitiveVerb ;
lug$uxs 	IntransitiveVerb ;
g_$os 	IntransitiveVerb ;
g_asg_$os 	IntransitiveVerb ;
kw'$adixsxw 	IntransitiveVerb ;
hl$o'ox_s 	IntransitiveVerb ;
b$ok_' 	IntransitiveVerb ;
k'$atsxw 	IntransitiveVerb ;
'$algax_ 	IntransitiveVerb ;
'al'$algax_ 	IntransitiveVerb ;
hal'$algax_ 	IntransitiveVerb ;
'$aajax_xw 	IntransitiveVerb ;
ginah$etxw 	IntransitiveVerb ;
hal$aagax_ 	IntransitiveVerb ;
hishal$aagax_xw 	IntransitiveVerb ;
ts'$ahlx_ 	IntransitiveVerb ;
'al$ayst 	IntransitiveVerb ;
ts'$iikw 	IntransitiveVerb ;
jixwts'$iikw 	IntransitiveVerb ;
d$aa'whl 	IntransitiveVerb ;
s$aks 	IntransitiveVerb ;
m$an 	IntransitiveVerb ;
y$al 	IntransitiveVerb ;
hiliy$al 	IntransitiveVerb ;
'$aapxin 	IntransitiveVerb ;
hil$in 	IntransitiveVerb ;
'n$akw 	IntransitiveVerb ;
hi'n$iiluxw 	IntransitiveVerb ;
g$a'lasxw 	IntransitiveVerb ;
j$ahl 	IntransitiveVerb ;
kw'$ootxw 	IntransitiveVerb ;
gwitkw'$ootxw 	IntransitiveVerb ;
'wii'am$e 	IntransitiveVerb ;
wit'ax_'alm$e 	IntransitiveVerb ;
g_$oo'os 	IntransitiveVerb ;
g$iihl 	IntransitiveVerb ;
l$aahl 	IntransitiveVerb ;
j$apxw 	IntransitiveVerb ;
jipj$apxw 	IntransitiveVerb ;
ts'$eek_xw 	IntransitiveVerb ;
g_ats'$eek_xw 	IntransitiveVerb ;
mo'ox_xw 	IntransitiveVerb ;
j$ilks 	IntransitiveVerb ;
y$ankw 	IntransitiveVerb ;
hl$antxw 	IntransitiveVerb ;
hlinhl$antxw 	IntransitiveVerb ;
l$ukw 	IntransitiveVerb ;
gy$oo 	IntransitiveVerb ;
l$oo 	IntransitiveVerb ;
'w$eesxw 	IntransitiveVerb ;
s$eegit 	IntransitiveVerb ;
ts'ax_'$utxw 	IntransitiveVerb ;
n$ee 	IntransitiveVerb ;
sg$i 	IntransitiveVerb ;
d$ox_ 	IntransitiveVerb ;
w$alix 	IntransitiveVerb ;
w$aax 	IntransitiveVerb ;
ts'$o'o 	IntransitiveVerb ;
g_awag$aani 	IntransitiveVerb ;
t'$aahlxw 	IntransitiveVerb ;
g$ahlxw 	IntransitiveVerb ;
gihlg$ahlxw 	IntransitiveVerb ;
ma'$us 	IntransitiveVerb ;
mahas'$us 	IntransitiveVerb ;
gw$ee'y 	IntransitiveVerb ;
g_agw$ee'y 	IntransitiveVerb ;
h$aax_xw 	IntransitiveVerb ;
'$ubin 	IntransitiveVerb ;
'ama'm$as 	IntransitiveVerb ;
'amal$imx_s 	IntransitiveVerb ;
'$ee'esxw 	IntransitiveVerb ;
'$aajax_ 	IntransitiveVerb ;
'$adixs 	IntransitiveVerb ;
d$amg_ansxw 	IntransitiveVerb ;
'ihl$ee'etxw 	IntransitiveVerb ;
m$asxw 	IntransitiveVerb ;
mism$asxw 	IntransitiveVerb ;
did$ilax_xw 	IntransitiveVerb ;
sgw$aa'ytxw 	IntransitiveVerb ;
luuy$altxw 	IntransitiveVerb ;
luuhily$altxw 	IntransitiveVerb ;
luuly$altxw 	IntransitiveVerb ;
m$ukw 	IntransitiveVerb ;
lax_l$ilp 	IntransitiveVerb ;
lax_lilpl$ilp 	IntransitiveVerb ;
l$ok_ 	IntransitiveVerb ;
l$oolax_ 	IntransitiveVerb ;
s$eeg_al 	IntransitiveVerb ;
sixs$eeg_al 	IntransitiveVerb ;
sax_s$eeg_al 	IntransitiveVerb ;
t'aab$eek_'xw 	IntransitiveVerb ;
b$ax_ 	IntransitiveVerb ;
g_$ol 	IntransitiveVerb ;
k'$eek_xw 	IntransitiveVerb ;
h$uut 	IntransitiveVerb ;
h$it' 	IntransitiveVerb ;
hith$it' 	IntransitiveVerb ;
'w$aa'atxw 	IntransitiveVerb ;
wax_'w$aa'atxw 	IntransitiveVerb ;
g_a'w$aa'atxw 	IntransitiveVerb ;
b$asax_xw 	IntransitiveVerb ;
'y$ak_ 	IntransitiveVerb ;
xwts'$agimsxw 	IntransitiveVerb ;
s$ak_ 	IntransitiveVerb ;
sax_s$ak_ 	IntransitiveVerb ;
xwd$akw 	IntransitiveVerb ;
d$ulpxw 	IntransitiveVerb ;
dild$ulpxw 	IntransitiveVerb ;
g_$ehlx_xw 	IntransitiveVerb ;
d$albixsxw 	IntransitiveVerb ;
t'$aa 	IntransitiveVerb ;
w$an 	IntransitiveVerb ;
g_$ehlx_ 	IntransitiveVerb ;
w$ok_ 	IntransitiveVerb ;
w$oowax_ 	IntransitiveVerb ;
w$oowox_ 	IntransitiveVerb ;
t'imw$ok_ 	IntransitiveVerb ;
'nimw$ok_ 	IntransitiveVerb ;
g_$esxw 	IntransitiveVerb ;
g_asg_$esxw 	IntransitiveVerb ;
sigy$ootxw 	IntransitiveVerb ;
l$altxw 	IntransitiveVerb ;
'al$isxw 	IntransitiveVerb ;
ts'$uusx 	IntransitiveVerb ;
sis$uus 	IntransitiveVerb ;
m$umk_' 	IntransitiveVerb ;
x_mi'y$een 	IntransitiveVerb ;
y$ahlxw 	IntransitiveVerb ;
h$at'iswa 	IntransitiveVerb ;
x_shan$eek_s 	IntransitiveVerb ;
gw$ee'yt 	IntransitiveVerb ;
hl$at'ax_ 	IntransitiveVerb ;
l$imx 	IntransitiveVerb ;
m$ilksax_ 	IntransitiveVerb ;
m$eex_ 	IntransitiveVerb ;
'$algax_ 	IntransitiveVerb ;
'al'$algax_ 	IntransitiveVerb ;
k_'$osx_ 	IntransitiveVerb ;
s$ak_' 	IntransitiveVerb ;
sgw$a 	IntransitiveVerb ;
h$etxw 	IntransitiveVerb ;
l$itxw 	IntransitiveVerb ;
x_sg$amks 	IntransitiveVerb ;
l$uwasxw 	IntransitiveVerb ;
'$isxw 	IntransitiveVerb ;
'as'$isxw 	IntransitiveVerb ;
'is'$isxw 	IntransitiveVerb ;
g_$esx_xw 	IntransitiveVerb ;
b$ahlx_ 	IntransitiveVerb ;
s$ak' 	IntransitiveVerb ;
sixs$ak' 	IntransitiveVerb ;
dax_g$at 	IntransitiveVerb ;
dahag$at 	IntransitiveVerb ;
ts'$ok_ 	IntransitiveVerb ;
hl$ok_'xw 	IntransitiveVerb ;
hl$oohlak_'xw 	IntransitiveVerb ;
hlg$ilkw 	IntransitiveVerb ;
'ixsd$a 	IntransitiveVerb ;
t'$axw 	IntransitiveVerb ;
g$itxw 	IntransitiveVerb ;
gitg$itxw 	IntransitiveVerb ;
h$adixs 	IntransitiveVerb ;
hath$adixs 	IntransitiveVerb ;
d$alk_ 	IntransitiveVerb ;
gaakw'iltxw 	IntransitiveVerb ;
ts'$iikw'inhlx_ 	IntransitiveVerb ;
h$e 	IntransitiveVerb ;
simh$e 	IntransitiveVerb ;
x_ts'$a'y 	IntransitiveVerb ;
l$iluxws 	IntransitiveVerb ;
g_al$iluxws 	IntransitiveVerb ;
h$anix 	IntransitiveVerb ;
hanh$anix 	IntransitiveVerb ;
gw$algwax_ 	IntransitiveVerb ;
'ax_g_alk_'$an 	IntransitiveVerb ;
hl$abixsxw 	IntransitiveVerb ;
hliphl$abixsxw 	IntransitiveVerb ;
k_'$atx_ 	IntransitiveVerb ;
s$ipxw 	IntransitiveVerb ;
sips$ipxw 	IntransitiveVerb ;
siil$inasxw 	IntransitiveVerb ;
'asg$i 	IntransitiveVerb ;
saahl$ee'e 	IntransitiveVerb ;
sg_$olts 	IntransitiveVerb ;
x_s$it 	IntransitiveVerb ;
gib$ee'esxw 	IntransitiveVerb ;
gy$uksxw 	IntransitiveVerb ;
lug$uxs 	IntransitiveVerb ;
lug$uxsxw 	IntransitiveVerb ;
g$amks 	IntransitiveVerb ;
liml$amk 	IntransitiveVerb ;
'$aks 	IntransitiveVerb ;
n$uuhlx_xw 	IntransitiveVerb ;
git'w$ink_ 	IntransitiveVerb ;
git'w$ink_xw 	IntransitiveVerb ;
m$aaxwsxw 	IntransitiveVerb ;
mism$aaxwsxw 	IntransitiveVerb ;
x_sd$aa 	IntransitiveVerb ;
'wiih$oo'osxw 	IntransitiveVerb ;
hahl$a'lst 	IntransitiveVerb ;
g_ahahl$a'lst 	IntransitiveVerb ;
g$iis 	IntransitiveVerb ;
gisg$iis 	IntransitiveVerb ;
w$il 	IntransitiveVerb ;
sitw$atxw 	IntransitiveVerb ;
'n$idinsxw 	IntransitiveVerb ;
sit'$aatxw 	IntransitiveVerb ;
sit'$aatxws 	IntransitiveVerb ;
sit'$aa'ma 	IntransitiveVerb ;
sity$eexw 	IntransitiveVerb ;
y$ukw 	IntransitiveVerb ;
l$ukw 	IntransitiveVerb ;
sag_aytg_$oot 	IntransitiveVerb ;
sag_aytg_$ooda 	IntransitiveVerb ;
'$ak_hlxw 	IntransitiveVerb ;
'$ak_xw 	IntransitiveVerb ;
singw$iikw 	IntransitiveVerb ;
sinh$un 	IntransitiveVerb ;
sis$atxw 	IntransitiveVerb ;
y$ak_ 	IntransitiveVerb ;
lisl$isxw 	IntransitiveVerb ;
sa'anj$ok_ 	IntransitiveVerb ;
sa'ants'$ap 	IntransitiveVerb ;
w$aatxw 	IntransitiveVerb ;
sg$at 	IntransitiveVerb ;
ts'$axw 	IntransitiveVerb ;
sil$imx 	IntransitiveVerb ;
'ang$a'la 	IntransitiveVerb ;
g_$ooda 	IntransitiveVerb ;
did$ilx_xw 	IntransitiveVerb ;
ts'$atxw 	IntransitiveVerb ;
'ax_'$algax_ 	IntransitiveVerb ;
'ax_'al'$algax_ 	IntransitiveVerb ;
'an$ook_ 	IntransitiveVerb ;
n$ook_ 	IntransitiveVerb ;
b$ee'esxw 	IntransitiveVerb ;
'$ak_ 	IntransitiveVerb ;
t'$uu'w 	IntransitiveVerb ;
sag_aytw$an 	IntransitiveVerb ;
miy$uxws 	IntransitiveVerb ;
x_sd$altxw 	IntransitiveVerb ;
lax_sd$altxw 	IntransitiveVerb ;
g$aks 	IntransitiveVerb ;
x_shan$eek_ 	IntransitiveVerb ;
y$altxw 	IntransitiveVerb ;
lax_'n$isxw 	IntransitiveVerb ;
nax_'n$isxw 	IntransitiveVerb ;
x_a'n$isxw 	IntransitiveVerb ;
hlg$uxws 	IntransitiveVerb ;
l$ooyk 	IntransitiveVerb ;
ksihl$o'otxw 	IntransitiveVerb ;
tw$a'lixsxw 	IntransitiveVerb ;
t'im$ist 	IntransitiveVerb ;
x_sb$idixsxw 	IntransitiveVerb ;
x_hlaaky'$ul 	IntransitiveVerb ;

LEXICON IntransitiveVerb

LEXICON RootPreverb
j$ag_a 	Preverb ;
j$og_o 	Preverb ;
sg_$a 	Preverb ;
b$alim 	Preverb ;
tk_'$al 	Preverb ;
hlib$alt 	Preverb ;
xwhl$ii 	Preverb ;
w$isin 	Preverb ;
h$ahl 	Preverb ;
tx_$as 	Preverb ;
tk'$u 	Preverb ;
kw'$ihl 	Preverb ;
k'ilk_'al 	Preverb ;
k'$utk'u 	Preverb ;
g$utk'u 	Preverb ;
'$asi 	Preverb ;
k'$aahl 	Preverb ;
l$uub$ag_ayt 	Preverb ;
x_hl$ip 	Preverb ;
'$alda 	Preverb ;
'$ahlda 	Preverb ;
s$aa 	Preverb ;
g$uxws 	Preverb ;
ts'$iihl 	Preverb ;
h$ii 	Preverb ;
g$ina 	Preverb ;
g$un 	Preverb ;
h$i'la 	Preverb ;
'n$aa 	Preverb ;
'y$ag_a 	Preverb ;
t'$ip 	Preverb ;
g$isa 	Preverb ;
n$a 	Preverb ;
tx_$aa 	Preverb ;
t$aax_ 	Preverb ;
d$ax_ 	Preverb ;
g_an$iis 	Preverb ;
'w$ahlin 	Preverb ;
'w$idin 	Preverb ;
h$aldim 	Preverb ;
'$uxs 	Preverb ;
s$og_om 	Preverb ;
d$uula 	Preverb ;
l$uu 	Preverb ;
'ahlax_ 	Preverb ;
l$uus$aa 	Preverb ;
b$ag_ayt 	Preverb ;
x_ts'$i 	Preverb ;
l$og_om 	Preverb ;
l$ag_am 	Preverb ;
ts'$ilim 	Preverb ;
ts'$imwil 	Preverb ;
ts'$imil 	Preverb ;
l$ok_'on 	Preverb ;
l$og_on 	Preverb ;
g_$aldix 	Preverb ;
h$adix 	Preverb ;
h$agun 	Preverb ;
h$agwin 	Preverb ;
h$ogwin 	Preverb ;
h$ogun 	Preverb ;
gw$in 	Preverb ;
'n$ii 	Preverb ;
sd$ax_ 	Preverb ;
m$ax_ 	Preverb ;
t'$uxs 	Preverb ;
xs$i 	Preverb ;
sb$i 	Preverb ;
'n$aa 	Preverb ;
'n$ik_'an 	Preverb ;
b$alx_sim 	Preverb ;
g_$alsim 	Preverb ;
x_hl$im 	Preverb ;
m$ax_hliks 	Preverb ;
m$ax_hli 	Preverb ;
'm$ax_hli 	Preverb ;
x_b$il 	Preverb ;
gy$uwil 	Preverb ;
'$aluu 	Preverb ;
h$is 	Preverb ;
'm$asim 	Preverb ;
k'$aduu 	Preverb ;
h$agul 	Preverb ;
s$ix 	Preverb ;
l$ixs 	Preverb ;
b$algi 	Preverb ;
b$aligi 	Preverb ;
h$a'tixs 	Preverb ;
g_$alksi 	Preverb ;
l$aax_ 	Preverb ;
g$is 	Preverb ;
g_$al 	Preverb ;
l$og_ox_ 	Preverb ;
g$ildip 	Preverb ;
b$ax_ 	Preverb ;
'm$in 	Preverb ;
k_'$ali 	Preverb ;
h$asba 	Preverb ;
'n$im 	Preverb ;
s$ak_'ap 	Preverb ;
l$uutk'u 	Preverb ;
l$utk'u 	Preverb ;
s$ik'ihl 	Preverb ;
s$i'ix 	Preverb ;
w$ats' 	Preverb ;
'w$ihl 	Preverb ;
k'$ila 	Preverb ;
g$ila 	Preverb ;
x_hl$aa 	Preverb ;

LEXICON Preverb

LEXICON RootModifier
gw$alk_'a 	Modifier ;
w$alk_'a 	Modifier ;
y$ag_ayt 	Modifier ;
sb$ag_ayt 	Modifier ;
sb$aayt 	Modifier ;
'w$ii 	Modifier ;
w$it'ax_ 	Modifier ;
w$iit'ax_ 	Modifier ;
w$ag_ayt 	Modifier ;
w$aayt 	Modifier ;
l$ukw'il 	Modifier ;
xs$ax_ 	Modifier ;
xs$aa 	Modifier ;
m$ahla 	Modifier ;
s$ag_ayt 	Modifier ;
s$aayt 	Modifier ;
s$im 	Modifier ;
s$aam 	Modifier ;
g$uu 	Modifier ;
g$uxw 	Modifier ;
l$ip 	Modifier ;
s$il 	Modifier ;
g_$an 	Modifier ;
g_$ani 	Modifier ;
k'$aa 	Modifier ;

LEXICON Modifier

LEXICON RootAdverb
g_$aniwila 	Adverb ;
g_$anwila 	Adverb ;
hlag_$ok_ 	Adverb ;
hlag_$ook_ 	Adverb ;
g_ad$o'ohlky'$oots 	Adverb ;
gik'$uuhl 	Adverb ;
siigy$uu'n 	Adverb ;
jox_k'$uuhl 	Adverb ;
g$ax_xw 	Adverb ;
hu'w$andii 	Adverb ;
ha'w$andii 	Adverb ;
ha'w$endii 	Adverb ;
gy$uu'n 	Adverb ;
g$alk_ 	Adverb ;
'and$oosda 	Adverb ;
d$uu'u 	Adverb ;
t'ihl$akw 	Adverb ;
t'aahl$akw 	Adverb ;
gax_g$u 	Adverb ;
nd$a 	Adverb ;
hind$a 	Adverb ;
ky'$oots 	Adverb ;
d$oosda 	Adverb ;

LEXICON Adverb

LEXICON RootSubordinator
m$ooji 	Subordinator ;
'$upji 	Subordinator ;
h$a'w 	Subordinator ;
sg$idim 	Subordinator ;
sg$idim 	Subordinator ;
hl$aa 	Subordinator ;
j$i 	Subordinator ;
j$idaa 	Subordinator ;
j$ida 	Subordinator ;
'$ii 	Subordinator ;
w$il 	Subordinator ;
w$in 	Subordinator ;
hlid$aa 	Subordinator ;
w$ila 	Subordinator ;

LEXICON Subordinator

LEXICON RootCommand
g_$ala 	Command ;
g_$alsi'm 	Command ;
gy$op' 	Command ;
t'asx$u 	Command ;
t'asx$usi'm 	Command ;

LEXICON Command

LEXICON RootPrenoun
g_$al 	Prenoun ;
ts'$im 	Prenoun ;
s$ii 	Prenoun ;
l$ax_ 	Prenoun ;
hlg$u 	Prenoun ;
k'$uba 	Prenoun ;
s$in 	Prenoun ;
gw$iis 	Prenoun ;

LEXICON Prenoun

LEXICON RootQuantifier
hlib$uu 	Quantifier ;
h$elt 	Quantifier ;
g_ab$i 	Quantifier ;
hlag_ats'$uu 	Quantifier ;
hlog_ots'$uu 	Quantifier ;
g_asg_$oo 	Quantifier ;

LEXICON Quantifier

LEXICON RootModal
d$im 	Modal ;
j$i 	Modal ;

LEXICON Modal

LEXICON RootAuxiliary
sg$i 	Auxiliary ;
n$ee 	Auxiliary ;
y$ukw 	Auxiliary ;
hl$is 	Auxiliary ;
g_$os 	Auxiliary ;

LEXICON Auxiliary

LEXICON RootParticle
n$ee 	Particle ;
'$ee'e 	Particle ;

LEXICON Particle

LEXICON RootClauseModifier
k_'$am 	ClauseModifier ;
'$am 	ClauseModifier ;
k_'$ap 	ClauseModifier ;
'$ap 	ClauseModifier ;
k_'$ay 	ClauseModifier ;
'$alp'a 	ClauseModifier ;
h$ets'im 	ClauseModifier ;
h$eksim 	ClauseModifier ;
h$ets'iksim 	ClauseModifier ;
h$oo 	ClauseModifier ;
h$ox_ 	ClauseModifier ;
h$uxw 	ClauseModifier ;
g_$an 	ClauseModifier ;
g_$ayhoo 	ClauseModifier ;
g_$ayoo 	ClauseModifier ;
g_$ayhuxw 	ClauseModifier ;
g_$as 	ClauseModifier ;
g_$aks 	ClauseModifier ;
gw$aa'y 	ClauseModifier ;

LEXICON ClauseModifier

LEXICON RootNumber
k'$i'y 	Number ;
k'$eekw 	Number ;
ky'$ul 	Number ;
g$ilbil 	Number ;
t'ipx_$aat 	Number ;
bag_ad$il 	Number ;
gwil$a'l 	Number ;
gwil$an 	Number ;
gwil$un 	Number ;
tx_$alpx_ 	Number ;
tk_'$alpx_ 	Number ;
tx_alpx_d$ul 	Number ;
xwsd$ins 	Number ;
xwsdins$ul 	Number ;
k_'$oolt 	Number ;
k_'oold$ul 	Number ;
t'ipx_$oo'lt 	Number ;
t'ipx_oo'ld$ul 	Number ;
g_and$oo'lt 	Number ;
g_andoo'ld$ul 	Number ;
ky'uxd$aa'lt 	Number ;
ky'uxdaa'ld$ul 	Number ;
xwsdim$oos 	Number ;
xwsdimoos$ul 	Number ;
xb$i'l 	Number ;
k'$ap 	Number ;
xb$ul 	Number ;
xbi'ldik'$i'y 	Number ;
xbi'ldig$ilbil 	Number ;
xbi'ldigwil$a'l 	Number ;
xbi'lditx_$alpx_ 	Number ;
xbi'lduxsd$ins 	Number ;
xbi'ldik_'$oo'lt 	Number ;
xbi'ldit'ipx_$oo'lt 	Number ;
xbi'ldig_and$oo'lt 	Number ;
xbi'ldiky'uxd$aa'lt 	Number ;
xbi'lduxsdim$oos 	Number ;
g$ilbilwilk'$ap 	Number ;
gwil$a'lwilk'$ap 	Number ;
k'ild$akhlwilk'$ap 	Number ;
xwsd$inswilk'$ap 	Number ;
k_'$oo'lwilk'$ap 	Number ;
t'ipx_$oo'lwilk'$ap 	Number ;
ky'uxd$aa'lwilk'$ap 	Number ;
xwsdim$ooswilk'$ap 	Number ;
k'$i'ywilk'$apt 	Number ;
k'$i'ydik'$ap 	Number ;
k'$i'lixs 	Number ;

LEXICON Number

LEXICON RootAddressForm
y$e'e 	AddressForm ;
ts'$iits' 	AddressForm ;
j$iits' 	AddressForm ;
b$aap 	AddressForm ;
bab$a 	AddressForm ;
d$ii'y 	AddressForm ;
n$aa'a 	AddressForm ;
b$iip 	AddressForm ;
b$ii'y 	AddressForm ;
dad$a 	AddressForm ;
w$ak 	AddressForm ;
d$iikw 	AddressForm ;
d$oots 	AddressForm ;
'$o'os 	AddressForm ;

LEXICON AddressForm

!!

LEXICON IntransitiveVerb
+VI:	VIDeriv ;

LEXICON VIDeriv
	VIInfl ;

LEXICON VIInfl
-ATTR:^m	# ;
	Word ;
	SeriesII ;
	daPlClitic ;
	SX ;

LEXICON TransitiveVerb
+VT:		VTDeriv ;

LEXICON VTDeriv
	VTInfl ;
	# ;		! for e.g. complement clause verbs
@D.VAL.BIGT@-T:@D.VAL.BIGT@^T 			VTInfl ;

LEXICON VTInfl
		SeriesII ;
-TR:^i	SeriesII ;
		

LEXICON Noun
+N: 	NDeriv ;

LEXICON NDeriv
-T:^T		SeriesII ;
-VAL:^xw	SeriesII ;
-VAL:^xw	SX ;
			Resemb ;
			NInfl ;

LEXICON NInfl
-ATTR:^m	# ;
-ATTR:^a	# ;
		SeriesII ;
		SX ;
		Word ;

LEXICON AddressForm
+VOC: Word ;


LEXICON Modifier
+MDF:	#;
+MDF-:^	RootIntransitiveVerb;
+MDF-:^	RootTransitiveVerb;
+MDF-:^	RootNoun;

LEXICON ClauseModifier
+MDF:	#;
+MDF:	SeriesIencl3;

LEXICON Preverb
+PVB:	#;
+PVB-:^	RootIntransitiveVerb;
+PVB-:^	RootTransitiveVerb;

LEXICON Prenoun
+PNN:	#;
+PNN-:^	RootNoun;

LEXICON Adverb
+ADV:	Word;


LEXICON Quantifier
+QUA:	QuantificationalInfl;

LEXICON Number
+NUM:	QuantificationalInfl;

LEXICON QuantificationalInfl
	Word ;
	SX ;
    AgreeingNClitic ;
-1PL.II:^'m	Word ;
-2PL.II:^si'm	Word ;
-3PL.II:^diit	Word ;

LEXICON Particle
+PT:	# ;


LEXICON SeriesII
-1SG.II:^'y	Word ;
-1PL.II:^'m	Word ;
-2SG.II:^n		Word ;
-2PL.II:^si'm	Word ;
-3.II:^t		Word ;
-3PL.II:^diit	Word ;
	AgreeingNClitic ;

LEXICON AgreeingNClitic
[-3.II]=CN:^hl	# ;
[-3.II]=PN:^s	# ;
[-3.II]=PN:^s	DemonstrativeClitic ;

LEXICON SX
-SX:^it		Word ;
-SX:^it		Resemb ;

LEXICON daPlClitic
-3PL.INDP:^da	# ;

LEXICON Command
+IMP:	#;

LEXICON SeriesIprocl
@P.SI.1@1.I=:@P.SI.1@n^	SeriesIable ;
@P.SI.2@2.I=:@P.SI.2@m^	SeriesIable ;

LEXICON SeriesIable
	RootModal ;
	RootSubordinator ;
	RootAuxiliary ;

LEXICON SeriesI
1.I:na 		# ;
1PL.I:dip 	# ;
2.I:mi 		# ;
2.I:ma 		# ;
2PL.I:sim 	# ;

LEXICON Auxiliary
@P.CAT.AUX@+AUX:@P.CAT.AUX@	SeriesIencl ;
@P.CAT.AUX@+AUX:@P.CAT.AUX@	SecPosClitic ;
@P.CAT.AUX@+AUX:@P.CAT.AUX@	CNClitic ;
@P.CAT.AUX@+AUX:@P.CAT.AUX@	SX ;

LEXICON Subordinator
+SUB:	SeriesIencl ;

LEXICON Modal
+MOD:	SeriesIencl;

LEXICON SeriesIencl
@D.SI@=1.I:@D.SI@^n			# ;	! used = instead of ^ to condition special epenthesis
@D.SI@=2.I:@D.SI@^m			# ;
!=2.I=2PL.I:^m^sim	# ;
	SeriesIencl3 ;

LEXICON SeriesIencl3
@D.SI@=3.I:@D.SI@^t			# ;
				# ;


LEXICON Root
	Exceptions ;

LEXICON Exceptions
w$il+VI-2SG.II:win		Word ;
w$il+VI-2PL.II:wisi'm	Word ;
w$il+VI=CN:wihl		# ;
w$il+VI[-3.II]=CN:wihl	# ;
w$il+VI[-3.II]=PN:wis	# ;

y$ee+VI-2SG.II:yin 	Word ;

w$in+SUB=1.I:wina		# ;
n$ee+AUX=d$im+MOD:nem	# ;
d$im+MOD=2.I:dima	# ;

2SG+OBL:lun 		Word ;
3.III+PRO=CN:'nihl		# ;


LEXICON Root
	Preposition ;
	Conjunction ;
	Pronoun ;
	NProclitic ;
	Quotative ;
	SeriesI ;
	SeriesIprocl ;
	Operator;

LEXICON Preposition
g_$o'o+P:g_$o'o	# ;
g_$o'o+P:g_$o'o	SeriesII ;
g_$oo+P:g_$oo	# ;
g_$oo+P:g_$oo	SeriesII ;
g_$a'a+P:g_$a'a	# ;
g_$a'a+P:g_$a'a	SeriesII ;
'$a+P:'$a 			# ;
'$a+P:'$a 			AgreeingNClitic ;
'$a+P-OBL:'$a^l$oo		AgreeingNClitic ;

LEXICON Conjunction
g_an+CNJ:g_an		NextNClitic ;
'$oo+CNJ:'$oo			# ;

LEXICON Pronoun
1SG.III+PRO:'nii'y 	Word ;
1PL.III+PRO:'nuu'm	Word ;
2SG.III+PRO:'niin 	Word ;
2PL.III+PRO:'nisi'm 	Word ;
3.III+PRO:'nit 		Word ;
3PL.III+PRO:'nidiit 	Word ;
1SG+OBL:loo'y 	Word ;
1PL+OBL:loo'm	Word ;
2SG+OBL:loon 	Word ;
2PL+OBL:loosi'm 	Word ;
3+OBL:loot 		Word ;
3PL+OBL:loodiit 	Word ;

LEXICON NProclitic
PN:t		# ;
PN:t		DemonstrativeClitic ;
ASSOC:dip	# ;
ASSOC:dip	DemonstrativeClitic ;

LEXICON DemonstrativeClitic
=PROX+DEM:=un	Word ;
=DIST+DEM:=ust	Word ;

LEXICON Quotative
1SG+QUOT:niy$a	QuotativeEnding ;
2SG+QUOT:miy$a	QuotativeEnding ;
3SG+QUOT:diy$a	QuotativeEnding ;
1PL+QUOT:diph$ii		QuotativePlEnding ;
2PL+QUOT:masimh$ii	QuotativePlEnding ;
3PL+QUOT:dah$iit	QuotativePlEnding ;
3PL+QUOT:d$iit		QuotativePlEnding ;

LEXICON QuotativePlEnding
				# ;
-3PL.INDP:^da 	QuotativeEnding ;

LEXICON QuotativeEnding
	NextNClitic ;
	SecPosClitic ;

LEXICON Operator
FOC+OP:dii		SeriesIencl ;
FOC+OP:dii		PNClitic;
PART+OP:hli		SeriesIencl ;
AX+OP:an 		SeriesIencl3 ;
DWID+OP:l$igi	PNClitic ;

LEXICON Word
	SecPosClitic ;
@D.CAT.AUX@	PhraseClitic ;
@D.CAT.AUX@	SentFinalClitic ;

LEXICON PhraseClitic
=PROX:^si 	NextNClitic ;
=PROX:^sa 	NextNClitic ;
=PR.EV:^gi 	NextNClitic ;
		 	NextNClitic ;

LEXICON Resemb
=RESEM:^ii 	CNClitic ;

LEXICON NextNClitic
	CNClitic ;
	PNClitic ;

LEXICON CNClitic
=CN:^hl	# ;
		# ;

LEXICON PNClitic
=PN:^t	# ;
		# ;

LEXICON SecPosClitic
@R.CAT.AUX@=EPIS:@R.CAT.AUX@^ima'a	SeriesIencl ;
@R.CAT.AUX@=EPIS:@R.CAT.AUX@^imaa	SeriesIencl ;
=EPIS:^ima'a	CNClitic ;
=EPIS:^imaa	CNClitic ;
=REPORT:^g_at	CNClitic ;

LEXICON SentFinalClitic
=YNQ:^aa	# ;
=QUDD:^ist	# ;
=QUDD:^is	# ;

! still need to test these e.g. with vowel hiatus interaction
